NO xpms/xpm0.xpm
SO xpms/xpm1.xpm
EA xpms/xpm2.xpm
WE xpms/xpm3.xpm

F 255,50,25
C 50,50,50


1111111111111111111111
10000000000000000001
10000000000000000001
10000000000000000011111111111111
110000000000000000111
100000S0000000000011
10000000000000000001
10000000000000000001
10000000000000000001
10000000000000000001
10000000000000000001
10000000000000000001
10000000000000000001
10000000000000000001
10000000000000000001
11000100000000000001
1111111111111111111111